1111111111111111
100000C000C00001
1000000C0000E001
1000000010P00001
1111111111111111