1111111111111111
1000000000C00001
100000000000E001
1CCCCCCCCCPCCCC1
1111111111111111