111111111
10P0000E1
100000001
100C00001
111111111